/HHHHHHH/////////HHHHHHH////////////////////////////////////////////////////////////////////////////////////////////////////////////////
JGGGGGGGI///////JGGGGGGGI///////////////////////////////////////////////////////////////////////////////////////////////////////////////
J0000000I///////J0000000I///////////////////////////////////////////////////////////////////////////////////////////////////////////////
J0000000I///////J0000000I///////////////////////////////////////////////////////////////////////////////////////////////////////////////
J0000000I///////J0000000I///////////////////////////////////////////////////////////////////////////////////////////////////////////////
J0000000I///////J0000000I///////////////////////////////////////////////////////////////////////////////////////////////////////////////
/1111111/////////1111111////////////////////////////////////////////////////////////////////////////////////////////////////////////////
////////////////////////////////////////////////////////////////////////////////////////////////////////////////////////////////////////
////////////////////////////////////////////////////////////////////////////////////////////////////////////////////////////////////////
////////////////////////////////////////////////////////////////////////////////////////////////////////////////////////////////////////
////////////////////////////////////////////////////////////////////////////////////////////////////////////////////////////////////////
////////////////////////////////////////////////////////////////////////////////////////////////////////////////////////////////////////
////////////////////////////////////////////////////////////////////////////////////////////////////////XZZZZZZZZZZZZZZZW///////////////
////////////////////////////////////////////////////////////////////////////////////////////////////////XYYYYYYYYYYYYYYYW///////////////
////////////////////////////////////////////////////////////////////////////////////////////////////////XYYYYYYYYYYYYYYYW///////////////
////////////////////////////////////////////////////////////////////////////////////////////////////////XYYYYYYYYYYYYYYYW///////////////
////////////////////////////////////////////////////////////////////////////////////////////////////////XYYYYYYYYYYYYYYYW///////////////
///////////////////////////555555555555555555555555555555555555/////////////////////////////////////////XYBaaaaaaaaaaaaaF///////////////
///////////////////////////555555555589889889855555555555555555/////////////////////////////////////////XYW/////////////////////////////
///////////////////////////555555555589889889855555555555555555/////////////////////////////////////////XYW/////////////////////////////
///////////////////////////55555555558889898885555555555///////////////////////////////////////////XZZZZZYZZZZZZZZZZZZZZZZW/////////////
///////////////////////////55555555568889798886555555555///////////////////////////////////////////XYYYYYYYYYYYYYYYYYYYYYYW/////////////
///////////////////////////55555555566666666666555555555///////////////////////////////////////////EaaaaaaaaaaaaaaaaaaaaAYW/////////////
///////////////////////////55555555566666666666555555555////////////////////////////////////////////////////////////////XYW/////////////
///////////////////////////5555555556666666666655555555555555555555////////////////////////////XZZW/////////////////////XYW/////////////
///////////////////////////5555555556666666666655555555555555555555////////////////////////////XYYZZZZZZZZZZZZZZZZZZZZZZZYW/////////////
///////////////////////////5555555556666666666655555555555555555555////////////////////////////XYYYYYYYYYYYYYYYYYYYYYYYYYYW/////////////
///////////////////////////5555555556666666666655555555555555555555////////////////////////////XYYBaaaaaaaaaaaaaAYYBaaaaaaF/////////////
///////////////////////////5555555555666666666555555555555555555555////////////////////////////XYYW/////////////XYYW////////////////////
///////////////////////////5555555555555555555555555555555555555555////////////////////////////XYYWXZZZZZZZZZZZZZYYZZZZZZW//////////////
///////////////////////////5555555555555555555555555555555555555555////////////////////////////XYYbcYYYYYYYYYYYYYYYYYYYYYZZZZZZW////////
///////////////////////////5555555555555555555555555555555555555555////////////////////////////XYYYYYYYYYYYYYYYYYYYYYYYYYYYYYYYW////////
///////////////////////////5555555555555555555555555555555555555555////////////////////////////XYYYYYYYYYYYYYYYYYYYYYYYYYYYYYYYW////////
///////////////////////////5555555555555555555555555555555555555555////////////////////////////EaaaAYYYYYYYYYYYYYYYYYYYYYBaaAYYW////////
///////////////////////////5555555555555555555555555555555555555555////////////////////////////////EaaaaaaAYYYYYYYBaaaaaaF//XYYW////////
///////////////////////////5555555555555555555555555555555555555555///////////////////////////////////////XYYYYYYYW////////XZYYW////////
///////////////////////////5555555555555555555555555555555555555555///////////////////////////////////////XYYYYYYYW////////XYYYW////////
///////////////////////////5555555555555555555555555555555555555555///////////////////////////////////////XYYYYYYYW////////EaaaF////////
///////////////////////////5555555555555555555555555555555555555555///////////////////////////////////////XYYYYYYYW/////////////////////
///////////////////////////5555555555555555555555555555555555555555///////////////////////////////////////EaaaaaaaF/////////////////////
///////////////////////////5555555555555555555555555555555555555555/////////////////////////////////////////////////////////////////////
///////////////////////////5555555555555555555555555555555555555555/////////////////////////////////////////////////////////////////////
///////////////////////////5555555555555555555555555555555555555555/////////////////////////////////////////////////////////////////////
////////////////////////////////////////////////////////////////////////////////////////////////////////////////////////////////////////
;