/HHHHHHH/////////HHHHHHH////////////////////////////////////////////////////////////////////////////////////////////////////////////////
JGGGGGGGI///////JGGGGGGGI///////////////////////////////////////////////////////////////////////////////////////////////////////////////
J0000000I///////J0000000I///////////////////////////////////////////////////////////////////////////////////////////////////////////////
J0000000I///////J0000000I///////////////////////////////////////////////////////////////////////////////////////////////////////////////
J0000000I///////J0000000I///////////////////////////////////////////////////////////////////////////////////////////////////////////////
J0000000I///////J0000000I///////////////////////////////////////////////////////////////////////////////////////////////////////////////
////////////////////////////////////////////////////////////////////////////////////////////////////////////////////////////////////////
////////////////////////////////////////////////////////////////////////////////////////////////////////////////////////////////////////
////////////////////////////////////////////////////////////////////////////////////////////////////////////////////////////////////////
////////////////////////////////////////////////////////////////////////////////////////////////////////////////////////////////////////
////////////////////////////////////////////////////////////////////////////////////////////////////////////////////////////////////////
////////////////////////////////////////////////////////////////////////////////////////////////////////////////////////////////////////
////////////////////////////////////////////////////////////////////////////////////////////////////////////////////////////////////////
////////////////////////////////////////////////////////////////////////////////////////////////////////////////////////////////////////
////////////////////////////////////////////////////////////////////////////////////////////////////////////////////////////////////////
////////////////////////////////////////////////////////////////////////////////////////////////////////////////////////////////////////
////////////////////////////////////////////////////////////////////////////////////////////////////////////////////////////////////////
///////////////////////////555555555555555555555555555555555555/////////////////////////////////////////////////////////////////////////
///////////////////////////555555555555555555555555555555555555/////////////////////////////////////////////////////////////////////////
///////////////////////////555555555555555555555555555555555555/////////////////////////////////////////////////////////////////////////
///////////////////////////55555555555555555555555555555////////////////////////////////////////////////////////////////////////////////
///////////////////////////55555555566666666666555555555////////////////////////////////////////////////////////////////////////////////
///////////////////////////55555555566666666666555555555////////////////////////////////////////////////////////////////////////////////
///////////////////////////55555555566666666666555555555////////////////////////////////////////////////////////////////////////////////
///////////////////////////5555555556666666666655555555555555555555/////////////////////////////////////////////////////////////////////
///////////////////////////5555555556666666666655555555555555555555/////////////////////////////////////////////////////////////////////
///////////////////////////5555555556666666666655555555555555555555/////////////////////////////////////////////////////////////////////
///////////////////////////5555555556666666666655555555555555555555/////////////////////////////////////////////////////////////////////
///////////////////////////5555555555666666666555555555555555555555/////////////////////////////////////////////////////////////////////
///////////////////////////5555555555555555555555555555555555555555/////////////////////////////////////////////////////////////////////
///////////////////////////5555555555555555555555555555555555555555/////////////////////////////////////////////////////////////////////
///////////////////////////5555555555555555555555555555555555555555/////////////////////////////////////////////////////////////////////
///////////////////////////5555555555555555555555555555555555555555/////////////////////////////////////////////////////////////////////
///////////////////////////5555555555555555555555555555555555555555/////////////////////////////////////////////////////////////////////
///////////////////////////5555555555555555555555555555555555555555/////////////////////////////////////////////////////////////////////
///////////////////////////5555555555555555555555555555555555555555/////////////////////////////////////////////////////////////////////
///////////////////////////5555555555555555555555555555555555555555/////////////////////////////////////////////////////////////////////
///////////////////////////5555555555555555555555555555555555555555/////////////////////////////////////////////////////////////////////
///////////////////////////5555555555555555555555555555555555555555/////////////////////////////////////////////////////////////////////
///////////////////////////5555555555555555555555555555555555555555/////////////////////////////////////////////////////////////////////
///////////////////////////5555555555555555555555555555555555555555/////////////////////////////////////////////////////////////////////
///////////////////////////5555555555555555555555555555555555555555/////////////////////////////////////////////////////////////////////
///////////////////////////5555555555555555555555555555555555555555/////////////////////////////////////////////////////////////////////
////////////////////////////////////////////////////////////////////////////////////////////////////////////////////////////////////////
;