 HHHHHHH    
JGGGGGGGI555555555555
J0000000I555555555555
J0000000I555555555555
J0000000I555555555555
J0000000I555555555555
/////////555555555555
/////////555555555555
/////////555555555555
;