/HHHHHHH/////////HHHHHHH////////////////////////////////////////////////////////////////////////////////////////////////////////////////
JGGGGGGGI///////JGGGGGGGI///////////////////////////////////////////////////////////////////////////////////////////////////////////////
J0000000I///////J0000000I///////////////////////////////////////////////////////////////////////////////////////////////////////////////
J0000000I///////J0000000I///////////////////////////////////////////////////////////////////////////////////////////////////////////////
J0000000I///////J0000000I///////////////////////////////////////////////////////////////////////////////////////////////////////////////
J0000000I///////J0000000I///////////////////////////////////////////////////////////////////////////////////////////////////////////////
////////////////////////////////////////////////////////////////////////////////////////////////////////////////////////////////////////
////////////////////////////////////////////////////////////////////////////////////////////////////////////////////////////////////////
////////////////////////////////////////////////////////////////////////////////////////////////////////////////////////////////////////
////////////////////////////////////////////////////////////////////////////////////////////////////////////////////////////////////////
//////////////////////////////////////55555555555555555555555555555/////////////////////////////////////////////////////////////////////
//////////////////////////////////////55555555555555555555555555555/////////////////////////////////////////////////////////////////////
//////////////////////////////////////55555555555555555555555555555/////////////////////////////////////////////////////////////////////
//////////////////////////////////////55555555555555555555555555555/////////////////////////////////////////////////////////////////////
//////////////////////////////////////55555555555555555555555555555/////////////////////////////////////////////////////////////////////
//////////////////////////////////////55555555555555555555555555555/////////////////////////////////////////////////////////////////////
//////////////////////////////////////55555555555555555555555555555/////////////////////////////////////////////////////////////////////
//////////////////////////////////////55555555555555555555555555555/////////////////////////////////////////////////////////////////////
//////////////////////////////////////55555555555555555555555555555/////////////////////////////////////////////////////////////////////
//////////////////////////////////////55555555555555555555555555555/////////////////////////////////////////////////////////////////////
//////////////////////////////////////55555555555555555555555555555/////////////////////////////////////////////////////////////////////
//////////////////////////////////////55555555555555555555555555555/////////////////////////////////////////////////////////////////////
//////////////////////////////////////55555555555555555555555555555/////////////////////////////////////////////////////////////////////
//////////////////////////////////////55555555555555555555555555555/////////////////////////////////////////////////////////////////////
//////////////////////////////////////55555555555555555555555555555/////////////////////////////////////////////////////////////////////
//////////////////////////////////////55555555555555555555555555555/////////////////////////////////////////////////////////////////////
//////////////////////////////////////55555555555555555555555555555/////////////////////////////////////////////////////////////////////
//////////////////////////////////////55555555555555555555555555555/////////////////////////////////////////////////////////////////////
//////////////////////////////////////55555555555555555555555555555/////////////////////////////////////////////////////////////////////
////////////////////////////////////////////////////////////////////////////////////////////////////////////////////////////////////////
;