////////////////////////////////////////////////////////////////////////////////////////////////////////////////////////////////////////
////////////////////////////////////////////////////////////////////////////////////////////////////////////////////////////////////////
/0/1234///////////W32140////////////////////////////////////////////////////////////////////////////////////////////////////////////////
/6////////////////////X6////////////////////////////////////////////////////////////////////////////////////////////////////////////////
////////////////////////////////////////////////////////////////////////////////////////////////////////////////////////////////////////
////5///////////////5///////////////////////////////////////////////////////////////////////////////////////////////////////////////////
////////////////////////////////////////////////////////////////////////////////////////////////////////////////////////////////////////
////////////////////////////////////////////////////////////////////////////////////////////////////////////////////////////////////////
////////////////////////////////////////////////////////////////////////////////////////////////////////////////////////////////////////
////////////////////////////////////////////////////////////////////////////////////////////////////////////////////////////////////////
////////////////////////////////////////////////////////////////////////////////////////////////////////////////////////////////////////
////////////////////////////////////////////////////////////////////////////////////////////////////////////////////////////////////////
////////////////////////////////////////////////////////////////////////////////////////////////////////////////////////////////////////
////////////////////////////////////////////////////////////////////////////////////////////////////////////////////////////////////////
////////////////////////////////////////////////////////////////////////////////////////////////////////////////////////////////////////
////////////////////////////////////////////////////////////////////////////////////////////////////////////////////////////////////////
////////////////////////////////////////////////////////////////////////////////////////////////////////////////////////////////////////
////////////////////////////////////////////////////////////////////////////////////////////////////////////////////////////////////////
//////////////////////////////////HH///////////HHHHHHHH/////////////////////////////////////////////////////////////////////////////////
//////////////////////////////////GG9/////////9GGGGGGGG/////////////////////////////////////////////////////////////////////////////////
////////////////////////////////CDHH8/T//T//T/8HHHHHHHH/////////////////////////////////////////////////////////////////////////////////
////////////////////////////////EFGG7T/T///T/T7GGGGGGGG/////////////////////////////////////////////////////////////////////////////////
//////////////////////////////////HHB////S////BHHHWHHHH/////////////////////////////////////////////////////////////////////////////////
////////////////////////////////CDGGB/////////BGGG/GGGG/////////////////////////////////////////////////////////////////////////////////
////////////////////////////////EFHHB/////////BHHH/HHHH/////////////////////////////////////////////////////////////////////////////////
//////////////////////////////////GGB/////////BGGG/GGGG/////////////////////////////////////////W///////////////////////////////////////
////////////////////////////////CDHH9/////////9HHH/HHHH/H/H/H/H/H//////////////////////////////////////////////////O//O/////////////////
////////////////////////////////EFGG8AAAA/AAAA8GGG/GGGGHGHGHGHGHG///////////////////////////////////////////////////////////////////////
//////////////////////////////////HH7VVVVUVVVV7////////G/G/G/G/G////////////////////////////////////////////////////////////////////////
////////////////////////////////CDGG///////////////////R//IJ/HHHH///////////////////////////////////////////////////////////////////////
////////////////////////////////EFHHHHHHHHH////////////O//KL/GGGG///////////////////////////////////////////////////////////////////////
//////////////////////////////////GGGGGGGGGH///////////R///SHHH/////////////////////////////////////////////////////////////////////////
////////////////////////////////CD/CD/CD/CDGH/H/H//////H///HGGG/////////////////////////////////////////////////////////////////////////
////////////////////////////////EF/EF/EF/EFHGHGHG/////HG//HGCD//////////////////////////////////////////////////////////////////////////
///////////////////////////////////////////GHGHG/H/H/HGH//GHEF//////////////////////////////////////////////////////////////////////////
/////////////////////////////////////////CDHGHGCDGHGHGHG//HGCD//////////////////////////////////////////////////////////////////////////
/////////////////////////////////////////EFGHGHEF/G/G/G///GHEF//////////////////////////////////////////////////////////////W///////////
///////////////////////////////////////////HGHG/S/////////HGCD//////////////////////////////////////////////////////////////////////////
/////////////////////////////////////////CDGHGH///////////GHEF//////////////////////////////////////////////////////////////////////////
/////////////////////////////////////////EFHGHGH/H/H/H/H/H/G////////////////////////////////////////////////////////////////////////////
///////////////////////////////////////////GHGHGHGHGHGHGHGHH////////////////////////////////////////////////////////////////////////////
////////////////////////////////////////////G/G/G/G/G/G/G/GG////////////////////////////////////////////////////////////////////////////
////////////////////////////////////////////////////////////////////////////////////////////////////////////////////////////////////////
////////////////////////////////////////////////////////////////////////////////////////////////////////////////////////////////////////
;