////////////////////////////////////////////////////////////////////////////////////////////////////////////////////////////////////////
////////////////////////////////////////////////////////////////////////////////////////////////////////////////////////////////////////
/0/1234////////////32140////////////////////////////////////////////////////////////////////////////////////////////////////////////////
/6/////////////////////6////////////////////////////////////////////////////////////////////////////////////////////////////////////////
////////////////////////////////////////////////////////////////////////////////////////////////////////////////////////////////////////
///555/////////////555//////////////////////////////////////////////////////////////////////////////////////////////////////////////////
////////////////////////////////////////////////////////////////////////////////////////////////////////////////////////////////////////
////////////////////////////////////////////////////////////////////////////////////////////////////////////////////////////////////////
////////////////////////////////////////////////////////////////////////////////////////////////////////////////////////////////////////
////////////////////////////////////////////////////////////////////////////////////////////////////////////////////////////////////////
////////////////////////////////////////////////////////////////////////////////////////////////////////////////////////////////////////
////////////////////////////////////////////////////////////////////////////////////////////////////////////////////////////////////////
////////////////////////////////////////////////////////////////////////////////////////////////////////////////////////////////////////
////////////////////////////////////////////////////////////////////////////////////////////////////////////////////////////////////////
////////////////////////////////////////////////////////////////////////////////////////////////////////////////////////////////////////
////////////////////////////////////////////////////////////////////////////////////////////////////////////////////////////////////////
////////////////////////////////////////////////////////////////////////////////////////////////////////////////////////////////////////
////////////////////////////////////////////////////////////////////////////////////////////////////////////////////////////////////////
//////////////////////////////////HH/HHHHHHHHH/HHHHHHHH/////////////////////////////////////////////////////////////////////////////////
//////////////////////////////////GG9GGGGGGGGG9GGGGGGGG/////////////////////////////////////////////////////////////////////////////////
////////////////////////////////CDHH8AAAAAAAAA8HHHHHHHH/////////////////////////////////////////////////////////////////////////////////
////////////////////////////////EFGG7/////////7GGGGGGGG/////////////////////////////////////////////////////////////////////////////////
//////////////////////////////////HHB/////////BHHHHHHHH/////////////////////////////////////////////////////////////////////////////////
////////////////////////////////CDGGB/////////BGGGGGGGG/////////////////////////////////////////////////////////////////////////////////
////////////////////////////////EFHHB/////////BHHHHHHHH/////////////////////////////////////////////////////////////////////////////////
//////////////////////////////////GGB/////////BGGGGGGGG/////////////////////////////////////////////////////////////////////////////////
////////////////////////////////CDHH9/////////9HHHHHHHH/H/H/H/H/H///////////////////////////////////////////////////////////////////////
////////////////////////////////EFGG8/////////8GGGGGGGGHGHGHGHGHG///////////////////////////////////////////////////////////////////////
//////////////////////////////////HH7AAAA/AAAA7////////G/G/G/G/G////////////////////////////////////////////////////////////////////////
////////////////////////////////CDGG///////////////////R//IJ/HHHH///////////////////////////////////////////////////////////////////////
////////////////////////////////EFHHHHHHHHH////////////O//KL/GGGG///////////////////////////////////////////////////////////////////////
//////////////////////////////////GGGGGGGGGH///////////R////HHH/////////////////////////////////////////////////////////////////////////
////////////////////////////////CD/CD/CD/CDGH/H/H//////H///HGGG/////////////////////////////////////////////////////////////////////////
////////////////////////////////EF/EF/EF/EFHGHGHG/////HG//HGCD//////////////////////////////////////////////////////////////////////////
///////////////////////////////////////////GHGHG/H/H/HGH//GHEF//////////////////////////////////////////////////////////////////////////
/////////////////////////////////////////CDHGHGCDGHGHGHG//HGCD//////////////////////////////////////////////////////////////////////////
/////////////////////////////////////////EFGHGHEF/G/G/G///GHEF//////////////////////////////////////////////////////////////////////////
///////////////////////////////////////////HGHG/S////P////HGCD//////////////////////////////////////////////////////////////////////////
/////////////////////////////////////////CDGHGH///////////GHEF//////////////////////////////////////////////////////////////////////////
/////////////////////////////////////////EFHGHGH/H/H/H/H/H/G////////////////////////////////////////////////////////////////////////////
///////////////////////////////////////////GHGHGHGHGHGHGHGHH////////////////////////////////////////////////////////////////////////////
////////////////////////////////////////////G/G/G/G/G/G/G/GG////////////////////////////////////////////////////////////////////////////
////////////////////////////////////////////////////////////////////////////////////////////////////////////////////////////////////////
////////////////////////////////////////////////////////////////////////////////////////////////////////////////////////////////////////
;