////////////////////////////////////////////////////////////////////////////////////////////////////////////////////////////////////////
////////////////////////////////////////////////////////////////////////////////////////////////////////////////////////////////////////
/0/1234////////////32140////////////////////////////////////////////////////////////////////////////////////////////////////////////////
/6/////////////////////6////////////////////////////////////////////////////////////////////////////////////////////////////////////////
////////////////////////////////////////////////////////////////////////////////////////////////////////////////////////////////////////
///555/////////////555//////////////////////////////////////////////////////////////////////////////////////////////////////////////////
////////////////////////////////////////////////////////////////////////////////////////////////////////////////////////////////////////
////////////////////////////////////////////////////////////////////////////////////////////////////////////////////////////////////////
////////////////////////////////////////////////////////////////////////////////////////////////////////////////////////////////////////
////////////////////////////////////////////////////////////////////////////////////////////////////////////////////////////////////////
////////////////////////////////////////////////////////////////////////////////////////////////////////////////////////////////////////
////////////////////////////////////////////////////////////////////////////////////////////////////////////////////////////////////////
////////////////////////////////////////////////////////////////////////////////////////////////////////////////////////////////////////
////////////////////////////////////////////////////////////////////////////////////////////////////////////////////////////////////////
////////////////////////////////////////////////////////////////////////////////////////////////////////////////////////////////////////
////////////////////////////////////////////////////////////////////////////////////////////////////////////////////////////////////////
////////////////////////////////////////////////////////////////////////////////////////////////////////////////////////////////////////
////////////////////////////////////////////////////////////////////////////////////////////////////////////////////////////////////////
//////////////////////////////////HH///////////HHHHHHHH/////////////////////////////////////////////////////////////////////////////////
//////////////////////////////////GG9/////////9GGGGGGGG/////////////////////////////////////////////////////////////////////////////////
//////////////////////////////////HH8AAAAAAAAA8HHHHHHHH/////////////////////////////////////////////////////////////////////////////////
//////////////////////////////////GG7/////////7GGGGGGGG/////////////////////////////////////////////////////////////////////////////////
//////////////////////////////////HHB/////////BHHHHHHHH/////////////////////////////////////////////////////////////////////////////////
//////////////////////////////////GGB/////////BGGGGGGGG/////////////////////////////////////////////////////////////////////////////////
//////////////////////////////////HHB/////////BHHHHHHHH/////////////////////////////////////////////////////////////////////////////////
//////////////////////////////////GGB/////////BGGGGGGGG/////////////////////////////////////////////////////////////////////////////////
//////////////////////////////////HH9/////////9HHHHHHHH/H/H/H/H/H///////////////////////////////////////////////////////////////////////
//////////////////////////////////GG8/////////8GGGGGGGGHGHGHGHGHG///////////////////////////////////////////////////////////////////////
//////////////////////////////////HH7AAAA/AAAA7////////G/G/G/G/G////////////////////////////////////////////////////////////////////////
//////////////////////////////////GG///////////////////R//IJ/HHHH///////////////////////////////////////////////////////////////////////
//////////////////////////////////HHHHHHHHH////////////O//KL/GGGG///////////////////////////////////////////////////////////////////////
//////////////////////////////////GGGGGGGGGH///////////R////HHH/////////////////////////////////////////////////////////////////////////
/////////////////////////////////////////CDGH/H/H//////H///HGGG/////////////////////////////////////////////////////////////////////////
/////////////////////////////////////////EFHGHGHG/////HG//HGCD//////////////////////////////////////////////////////////////////////////
///////////////////////////////////////////GHGHG/H/H/HGH//GHEF//////////////////////////////////////////////////////////////////////////
/////////////////////////////////////////CDHGHGCDGHGHGHG//HGCD//////////////////////////////////////////////////////////////////////////
/////////////////////////////////////////EFGHGHEF/G/G/G///GHEF//////////////////////////////////////////////////////////////////////////
///////////////////////////////////////////HGHG/5////P////HGCD//////////////////////////////////////////////////////////////////////////
/////////////////////////////////////////CDGHGH///////////GHEF//////////////////////////////////////////////////////////////////////////
/////////////////////////////////////////EFHGHGH/H/H/H/H/H/G////////////////////////////////////////////////////////////////////////////
///////////////////////////////////////////GHGHGHGHGHGHGHGHH////////////////////////////////////////////////////////////////////////////
////////////////////////////////////////////G/G/G/G/G/G/G/GG////////////////////////////////////////////////////////////////////////////
////////////////////////////////////////////////////////////////////////////////////////////////////////////////////////////////////////
////////////////////////////////////////////////////////////////////////////////////////////////////////////////////////////////////////
;